*S**********
*          *
*   *****  *
*    *     *
*******    *
*G         *
************