*************
*           *
*       *****
*           *
*    S      *
*           *
*           *
*******     *
*G          *
*************