********
*S     *
****  **
*      *
*   ****
*     **
* **  **
*     **
*G     *
********