********
*S    S*
****  **
*      *
*   ****
*     **
* **  **
*     **
*G     *
********